4,4,4,4,4,4,4,4,4,4,4,4,4,4,4,4,4,4,4,4,4,4,4,4,4,4,4,4,4,4,4,4,4,4,4,4,4,4,4,4,4,4,4,4,4,4,4,4,4,4,4,4,4,4,4,4,4,4,4,4,4,4,4,4
4,6,6,6,6,6,6,6,6,6,6,6,6,6,6,6,6,6,6,6,6,6,6,6,6,6,6,6,6,6,6,4,6,6,6,6,6,6,6,6,6,6,6,6,6,6,6,6,6,6,6,6,6,6,6,6,6,6,6,6,6,6,6,4
4,2,2,2,2,2,2,2,2,2,2,2,2,2,2,2,2,2,2,2,2,2,2,2,2,2,2,2,2,2,2,4,2,2,2,2,2,2,2,2,2,2,2,2,2,2,2,2,2,2,2,2,2,2,2,2,2,2,2,2,2,2,2,4
4,2,2,2,2,2,2,2,2,2,2,2,2,2,2,2,2,2,2,2,2,2,2,2,2,2,2,2,2,2,2,4,2,2,2,2,2,2,2,2,2,2,2,2,2,2,2,2,2,2,2,2,2,2,2,2,2,2,2,2,2,2,2,4
4,2,2,2,2,2,2,4,4,4,4,4,4,4,4,4,4,4,4,2,2,2,2,2,2,2,2,2,2,2,2,4,2,2,2,2,2,2,2,2,2,2,2,2,2,2,2,2,2,2,2,2,2,2,2,2,2,2,2,2,2,2,2,4
4,2,2,2,2,2,2,4,6,6,6,6,6,6,6,6,6,6,4,2,2,2,2,2,2,2,2,2,2,2,2,4,2,2,2,4,4,4,4,4,4,4,4,4,4,4,4,4,4,2,2,2,2,2,2,2,2,2,2,4,2,2,2,4
4,2,2,2,2,2,2,4,2,2,2,2,2,2,2,2,2,2,4,2,2,2,4,4,4,4,4,4,4,2,2,4,2,2,2,4,6,6,6,6,6,6,6,6,6,6,6,6,4,2,2,2,2,2,2,2,2,2,2,4,2,2,2,4
4,2,2,2,2,2,2,4,2,2,2,2,2,2,2,2,2,2,6,2,2,2,4,6,6,6,6,6,4,2,2,4,2,2,2,4,2,2,2,2,2,2,2,2,2,2,2,2,4,2,2,2,2,2,4,4,4,4,4,4,2,2,2,4
4,2,2,2,2,2,2,4,2,2,2,2,2,2,2,2,2,2,2,2,2,2,4,2,2,2,2,2,4,2,2,4,2,2,2,6,2,2,2,2,2,2,2,2,2,2,2,2,4,2,2,2,2,2,4,6,6,6,6,4,2,2,2,4
4,2,2,2,4,4,4,4,4,4,4,4,4,4,4,4,2,2,2,2,2,2,4,2,2,2,2,2,6,2,2,4,2,2,2,2,2,2,2,2,2,2,2,2,2,2,2,2,4,2,2,2,2,2,4,2,2,2,2,4,2,2,2,4
4,2,2,2,4,6,6,6,6,6,6,6,6,6,6,4,2,2,2,2,2,2,4,2,2,2,2,2,2,2,2,4,2,2,2,2,2,2,4,4,4,4,4,2,2,2,4,4,4,4,4,2,2,2,4,2,2,2,2,4,2,2,2,4
4,2,2,2,4,2,2,2,2,2,2,2,2,2,2,4,2,2,2,2,2,2,4,2,2,2,2,2,2,2,2,4,2,2,2,2,2,2,4,6,6,6,4,2,2,2,4,6,6,6,4,2,2,2,4,2,2,2,2,4,2,2,2,4
4,2,2,2,4,2,2,2,2,2,2,2,2,2,2,4,4,4,4,4,4,4,4,2,2,2,2,2,2,2,2,4,2,2,2,2,2,2,4,2,2,2,4,2,2,2,4,2,2,2,4,2,2,2,4,2,2,2,2,4,2,2,2,4
4,2,2,2,4,2,2,2,2,2,2,2,2,2,2,4,6,6,6,6,6,6,6,2,2,4,4,2,2,2,4,4,4,4,4,4,4,4,4,2,2,2,4,4,4,4,4,2,2,2,4,4,4,4,4,2,2,2,2,4,2,2,2,4
4,2,2,2,6,2,2,2,2,4,4,4,4,4,4,4,2,2,2,2,2,2,2,2,2,4,6,2,2,2,6,6,6,6,6,6,6,6,6,2,2,2,6,6,6,6,6,2,2,2,6,6,6,6,6,2,2,2,2,4,2,2,2,4
4,2,2,2,2,2,2,2,2,4,6,6,6,6,6,6,2,2,2,2,2,2,2,2,2,4,2,2,2,2,2,2,2,2,2,2,2,2,2,2,2,2,2,2,2,2,2,2,2,2,2,2,2,2,2,2,2,2,2,6,2,2,2,4
4,2,2,2,2,2,2,2,2,4,2,2,2,2,2,2,2,2,2,2,2,2,2,2,2,4,2,2,2,2,2,2,2,2,2,2,2,2,2,2,2,2,2,2,2,2,2,2,2,2,2,2,2,2,2,2,2,2,2,2,2,2,2,4
4,2,2,2,2,2,2,2,2,4,2,2,2,2,2,2,2,2,2,2,2,2,2,2,2,4,2,2,2,2,2,2,2,2,2,2,2,2,2,2,2,2,2,2,2,2,2,2,2,2,2,2,2,2,2,2,2,2,2,2,2,2,2,4
4,2,2,2,2,2,2,2,2,4,2,2,2,2,2,2,2,2,2,2,2,2,2,2,2,4,2,2,2,2,2,2,2,2,2,2,2,4,2,2,2,2,2,2,2,2,2,2,2,2,2,2,2,2,2,2,2,2,2,2,2,2,2,4
4,4,4,4,4,2,2,2,2,4,4,4,4,4,4,4,4,4,4,4,4,4,4,4,4,4,2,2,2,2,2,2,2,2,2,2,2,4,4,4,4,4,4,4,4,4,4,4,4,4,4,4,4,4,4,2,2,2,2,4,4,4,4,4
4,6,6,6,6,2,2,2,2,6,6,6,6,6,6,6,6,6,6,6,6,6,6,6,6,4,2,2,2,2,2,8,2,2,2,2,2,4,6,6,6,6,4,6,6,6,6,6,6,6,6,6,6,6,4,2,2,2,2,6,6,6,6,4
4,2,2,2,2,2,2,2,2,2,2,2,2,2,2,2,2,2,2,2,2,2,2,2,2,6,2,2,2,2,2,2,2,2,2,2,2,4,2,2,2,2,4,2,2,2,2,2,2,2,2,2,2,2,4,2,2,2,2,2,2,2,2,4
4,2,2,2,2,2,2,2,2,2,2,2,2,2,2,2,2,2,2,2,2,2,2,2,2,2,2,2,2,2,2,2,2,2,2,2,2,4,2,2,2,2,4,2,2,2,2,2,2,2,2,2,2,2,4,2,2,2,2,2,2,2,2,4
4,2,2,2,2,2,2,2,2,2,2,2,2,2,2,2,2,2,2,2,2,2,2,2,2,2,2,2,2,2,2,2,2,2,2,2,2,4,2,2,2,2,4,2,2,2,2,2,2,2,2,2,2,2,4,2,2,2,2,2,2,2,2,4
4,2,2,2,4,2,2,2,2,2,2,2,2,4,4,4,4,4,4,4,2,2,2,2,2,2,2,2,2,2,2,2,2,2,2,2,2,4,2,2,2,2,4,2,2,2,2,2,2,2,2,2,2,2,4,2,2,2,2,2,2,2,2,4
4,2,2,2,4,2,2,2,2,2,2,2,2,4,6,6,6,6,6,4,2,2,2,2,2,4,2,2,2,2,2,2,2,2,2,2,2,4,2,2,2,2,4,2,2,2,2,2,2,2,2,2,2,2,4,2,2,2,2,2,2,2,2,4
4,2,2,2,4,2,2,2,4,4,4,4,4,4,2,2,2,2,2,4,2,2,2,2,2,4,4,4,4,4,4,4,4,2,2,2,4,4,2,2,2,2,6,2,2,2,2,4,4,4,4,4,4,4,4,2,2,2,2,2,2,2,2,4
4,2,2,2,4,2,2,2,4,6,6,6,6,4,2,2,2,2,2,4,2,2,2,2,2,6,6,6,6,6,6,4,6,2,2,2,6,6,2,2,2,2,2,2,2,2,2,4,6,6,6,6,6,6,4,4,4,4,4,4,2,2,2,4
4,2,2,2,4,2,2,2,4,2,2,2,2,4,2,2,2,2,2,4,2,2,2,2,2,2,2,2,2,2,2,4,2,2,2,2,2,2,2,2,2,2,2,2,2,2,2,4,2,2,2,2,2,2,6,6,6,6,6,6,2,2,2,4
4,2,2,2,4,2,2,2,4,2,2,2,2,4,2,2,4,2,2,4,2,2,2,2,2,2,2,2,2,2,2,4,2,2,2,2,2,2,2,2,2,2,2,2,2,2,2,4,2,2,2,2,2,2,2,2,2,2,2,2,2,2,2,4
4,2,2,2,4,4,4,4,4,2,2,2,2,4,2,2,4,4,4,4,2,2,2,2,2,2,2,2,2,2,2,4,2,2,2,2,2,2,4,4,4,4,4,4,4,4,4,4,2,-1,2,2,2,2,2,2,2,2,2,2,2,2,2,4
4,2,2,2,6,6,6,6,6,2,2,2,2,4,2,2,6,6,6,6,2,2,4,4,4,4,4,4,4,4,4,4,2,2,2,2,2,2,4,6,6,6,6,6,6,6,6,4,2,2,2,2,2,2,2,2,2,2,2,2,2,2,2,4
4,2,2,2,2,2,2,2,2,2,2,2,2,4,2,2,2,2,2,2,2,2,4,6,6,6,6,6,6,6,6,6,2,2,2,2,2,2,4,2,2,2,2,2,2,2,2,4,4,4,4,4,4,4,4,4,4,2,2,2,2,2,2,4
4,2,2,2,2,2,2,2,2,2,2,2,2,4,2,2,2,2,2,2,2,2,4,2,2,2,2,2,2,2,2,2,2,2,2,2,2,2,4,2,2,2,2,2,2,2,2,6,6,6,6,6,6,6,6,6,4,2,2,2,2,2,2,4
4,2,2,2,2,4,4,4,4,2,2,2,2,4,4,4,4,4,4,4,4,4,4,2,2,2,2,2,2,2,2,2,2,2,2,2,2,2,6,2,2,2,2,2,2,2,2,2,2,2,2,2,2,2,2,2,4,2,2,2,2,2,2,4
4,2,2,2,2,6,6,6,4,2,2,2,2,6,6,6,6,6,6,6,6,6,6,2,2,2,2,2,2,2,2,2,2,2,2,2,2,2,2,2,2,2,2,2,2,2,2,2,2,2,2,2,2,2,2,2,4,2,2,2,2,2,2,4
4,2,2,2,2,2,2,2,4,2,2,2,2,2,2,2,2,2,2,2,2,2,2,2,2,2,2,2,2,2,2,4,2,2,2,2,2,2,2,2,2,2,2,2,2,2,2,2,2,2,2,2,2,2,2,2,4,2,2,2,2,2,2,4
4,2,2,2,2,2,9,2,4,2,2,2,2,2,2,2,2,2,2,2,2,2,2,2,2,2,2,2,2,2,2,4,2,2,2,2,2,2,2,2,2,2,2,2,2,2,2,2,2,2,2,2,2,2,2,2,4,2,2,2,2,2,2,4
4,2,2,2,2,2,2,2,4,2,2,2,2,2,2,2,2,2,2,2,2,2,2,2,2,2,2,2,2,2,2,4,2,2,2,2,2,2,2,2,2,2,2,2,2,2,2,2,2,2,2,2,2,2,2,2,4,2,2,2,2,2,2,4
4,4,4,4,4,4,4,4,4,4,4,4,4,4,4,4,4,4,4,4,4,4,4,4,4,4,4,4,4,4,4,4,4,4,4,4,4,4,4,4,4,4,4,4,4,4,4,4,4,4,4,4,4,4,4,4,4,4,4,4,4,4,4,4
